181 181 181 181 181 181 181 181 181 181 181 181 181 181 181 181 181 181 181 181 181 181 181 181 181 181 181 181 181 181 181 181 181 181 181 181 181 181 181 181 181 181 181 181 181 181 181 181 181 181 
181 183 184 184 184 184 184 184 184 184 184 184 184 184 184 184 184 184 184 184 184 184 184 184 184 184 184 184 184 184 184 184 184 184 184 184 184 184 184 184 184 184 184 184 184 184 184 184 185 181 
181 186 19 20 21 22 21 20 21 22 23 56 129 0 57 0 155 0 0 0 157 158 0 19 20 21 22 21 22 21 22 23 19 20 21 22 23 47 43 43 43 43 43 43 43 43 43 45 187 181 
181 186 24 25 26 27 26 27 26 27 28 19 20 21 22 21 22 21 22 23 159 160 0 24 25 26 27 26 27 26 27 28 24 25 26 27 28 39 141 56 59 88 89 90 59 56 141 39 187 181 
181 186 29 30 31 32 31 32 31 32 33 24 25 26 27 26 25 26 27 28 162 161 0 29 30 31 30 31 30 31 30 33 29 30 31 32 33 39 142 175 176 91 92 93 142 171 172 39 187 181 
181 186 62 63 63 64 139 145 154 157 158 29 30 31 32 31 32 31 32 33 171 172 0 35 35 35 0 0 169 136 150 151 126 58 175 176 56 39 142 177 178 94 95 96 54 173 174 39 187 181 
181 186 70 0 0 73 0 146 147 159 160 150 151 157 158 129 145 154 150 151 173 174 35 35 35 35 35 35 170 55 152 153 55 155 177 178 58 41 54 142 125 97 98 99 126 142 59 39 187 181 
181 186 74 76 77 79 58 148 149 162 161 152 153 159 160 0 146 147 152 153 0 0 35 169 157 158 35 35 35 35 205 206 210 206 210 206 210 206 210 207 59 234 211 142 56 54 142 39 187 181 
181 186 136 35 35 156 234 58 130 150 151 175 176 162 161 169 148 149 35 35 35 35 35 170 159 160 145 154 56 35 211 35 35 35 35 35 35 39 56 208 56 142 208 167 167 167 136 39 187 181 
181 186 145 154 35 35 35 35 35 152 153 177 178 0 155 170 0 35 35 19 20 21 22 23 162 161 146 147 150 151 208 35 155 131 132 135 169 39 141 209 206 210 212 168 168 168 141 39 187 181 
181 186 146 147 35 35 35 35 35 35 35 35 35 35 35 35 35 35 35 24 25 26 27 28 171 172 148 149 152 153 211 19 20 21 22 23 170 42 43 43 43 43 43 43 43 43 43 48 187 181 
181 186 148 149 155 35 35 35 35 35 35 35 35 35 35 35 35 35 35 29 30 31 32 33 173 174 50 139 125 56 208 24 25 26 27 28 55 175 176 126 0 19 20 21 22 21 22 23 187 181 
181 186 19 20 21 22 21 22 21 22 23 155 157 158 0 145 154 35 35 35 35 35 35 56 54 19 20 21 22 23 211 29 30 31 32 33 139 177 178 150 151 24 25 26 25 26 25 28 187 181 
181 186 24 25 26 27 26 27 26 27 28 131 159 160 0 146 147 35 35 35 35 35 35 150 151 24 25 26 25 28 208 0 19 20 21 20 21 20 23 152 153 29 30 31 30 31 30 33 187 181 
181 186 29 30 31 32 31 32 31 32 33 56 162 161 130 148 149 35 35 35 35 35 35 152 153 29 30 31 30 33 209 207 24 25 26 25 26 25 28 155 157 158 62 63 63 63 63 64 187 181 
181 186 19 20 21 22 23 126 157 158 19 20 23 56 175 176 0 35 35 35 35 19 20 21 22 21 22 21 22 21 23 211 29 30 31 32 31 32 33 169 159 160 65 141 0 0 0 69 187 181 
181 186 24 25 26 27 28 140 159 160 24 25 28 131 177 178 156 35 35 35 35 24 25 26 25 26 25 26 25 26 28 208 0 179 180 136 0 155 50 170 162 161 70 0 0 0 155 69 187 181 
181 186 29 30 31 32 32 0 162 161 29 30 33 55 35 35 35 35 35 35 156 29 30 31 30 31 30 31 30 31 30 209 210 206 210 206 210 206 210 207 171 172 74 75 76 77 78 79 187 181 
181 186 56 0 56 35 35 35 35 35 35 35 35 35 35 35 35 35 35 35 157 158 0 121 122 122 122 122 122 122 122 122 122 122 122 122 122 123 52 208 173 174 135 133 35 35 150 151 187 181 
181 186 155 145 154 35 35 35 35 35 35 35 35 35 35 35 35 35 35 35 159 160 122 156 0 156 0 143 144 0 143 144 0 156 0 143 144 0 123 211 150 151 169 132 35 35 152 153 187 181 
181 186 0 146 147 35 175 176 19 20 21 22 21 22 21 22 21 22 23 169 162 161 122 0 143 144 127 0 0 57 0 0 0 127 0 56 127 0 0 208 152 153 170 35 35 35 0 141 187 181 
181 186 0 148 149 35 177 178 24 25 26 25 26 25 26 25 26 25 28 170 0 155 122 126 0 0 0 0 56 0 0 57 58 0 0 0 156 0 52 212 35 35 35 35 35 157 158 169 187 181 
181 186 175 176 35 35 179 180 29 32 31 30 31 30 31 30 31 30 33 171 172 0 122 0 175 176 0 0 0 0 0 0 0 0 58 0 0 0 0 0 123 139 135 58 56 159 160 170 187 181 
181 186 177 178 35 35 155 157 158 150 151 156 145 154 19 20 23 175 176 173 174 130 122 156 177 178 126 127 126 0 121 0 57 50 121 127 0 156 0 122 35 133 179 180 134 162 161 56 187 181 
181 186 139 0 35 35 58 159 160 152 153 57 146 147 24 25 28 177 178 155 145 22 23 121 122 122 122 122 122 123 0 108 37 105 50 123 122 123 122 123 191 192 192 192 193 145 20 23 187 181 
181 186 56 169 35 35 0 162 161 58 169 155 148 149 29 30 33 169 140 0 24 25 28 102 118 101 120 100 19 20 23 110 37 105 157 158 191 192 192 192 190 181 182 166 195 24 27 28 187 181 
181 186 169 170 35 35 35 139 57 136 170 35 35 35 35 35 35 170 150 151 29 30 33 110 80 81 82 107 24 25 28 108 37 105 159 160 194 164 165 181 183 184 184 185 195 29 30 33 187 181 
181 186 170 157 158 35 35 35 35 35 35 35 35 35 35 35 35 233 152 153 56 139 56 109 83 0 84 106 29 32 33 108 37 105 162 161 194 181 181 182 186 56 131 187 195 133 175 176 187 181 
181 186 0 159 160 0 35 35 35 35 35 35 134 155 56 35 35 131 102 118 101 120 101 114 85 86 87 115 120 101 118 114 37 105 191 192 190 181 182 165 195 0 0 194 195 56 177 178 187 181 
181 186 155 162 161 138 35 35 35 35 19 20 21 22 21 22 23 169 109 36 37 36 36 37 116 111 112 111 111 111 111 111 112 104 187 166 182 182 163 182 195 0 233 194 195 150 151 56 187 181 
181 186 145 20 23 56 35 35 35 35 24 25 26 25 26 27 28 170 110 36 116 112 111 119 104 56 136 156 126 34 133 150 151 191 190 183 184 184 184 184 198 0 204 190 195 152 153 169 187 181 
181 186 24 25 28 0 35 35 35 136 29 32 29 32 29 32 33 56 108 36 107 19 20 21 20 21 20 21 20 23 134 152 153 194 181 186 157 158 55 0 0 0 187 165 195 157 158 170 187 181 
181 186 29 30 33 35 35 35 169 150 151 127 54 179 180 140 175 176 108 36 105 24 25 26 25 26 25 26 25 28 191 192 192 190 181 186 159 160 0 0 0 56 187 163 195 159 160 155 187 181 
181 186 0 35 35 35 0 58 170 152 153 57 126 56 54 155 177 178 108 36 105 29 30 31 30 31 30 31 30 33 199 164 181 181 181 186 162 161 0 0 0 0 187 182 195 162 161 0 187 181 
181 186 0 35 35 62 63 63 63 63 63 63 63 63 63 63 63 64 108 36 105 155 134 175 176 150 151 150 151 169 199 182 181 181 165 186 56 150 151 0 0 54 187 181 195 139 175 176 187 181 
181 186 0 35 0 65 19 20 21 22 23 133 0 0 0 233 0 69 109 36 105 133 56 177 178 152 153 152 153 170 199 181 181 163 182 186 131 152 153 1 2 0 187 181 195 56 177 178 187 181 
181 186 156 0 0 65 24 25 26 27 28 155 102 118 101 120 100 69 108 36 106 191 192 192 192 192 192 192 192 192 190 181 182 181 181 188 189 189 189 13 14 189 190 181 195 145 154 56 187 181 
181 186 157 158 155 65 29 30 31 32 33 102 114 36 36 36 107 69 108 36 105 187 181 182 182 164 181 181 183 184 184 184 184 184 184 184 184 185 163 13 14 181 181 165 195 146 147 139 187 181 
181 186 159 160 58 65 145 154 56 102 118 114 36 36 116 112 104 69 108 36 105 187 165 163 181 182 181 181 186 56 141 0 0 0 56 150 151 187 182 13 14 182 181 182 195 148 149 57 187 181 
181 186 162 161 56 65 146 147 156 109 36 36 116 112 104 133 169 69 110 36 105 7 15 15 15 15 15 15 12 0 0 0 0 0 0 152 153 7 15 13 14 15 15 15 12 167 157 158 187 181 
181 186 19 20 23 65 148 149 0 110 36 36 106 68 150 151 170 69 108 36 107 215 215 215 215 215 215 215 216 0 0 19 22 23 0 0 0 214 215 13 14 215 215 215 216 168 159 160 187 181 
181 186 24 27 28 70 0 0 133 108 36 36 105 53 152 153 56 73 108 36 105 8 16 16 16 16 16 16 11 0 0 24 27 28 0 0 0 8 16 13 14 16 16 16 11 56 162 161 187 181 
181 186 29 30 33 74 75 75 75 75 76 77 78 78 78 78 78 79 110 36 105 187 166 181 182 183 197 197 201 0 34 29 32 33 0 0 126 187 181 13 14 181 181 181 195 19 20 23 187 181 
181 186 19 20 21 22 21 22 23 109 36 36 115 120 101 101 101 118 114 36 105 187 181 181 165 195 0 0 0 0 204 189 189 189 189 189 189 190 181 13 14 181 181 165 195 24 25 28 187 181 
181 186 24 25 26 25 26 25 28 103 117 36 36 36 36 36 36 36 36 36 105 187 182 163 181 195 133 0 0 204 190 181 181 163 181 181 181 165 181 13 14 181 163 181 195 29 32 33 187 181 
181 186 146 27 26 27 26 27 28 56 103 119 111 111 112 111 111 111 113 111 104 187 182 182 164 188 189 189 189 190 181 182 165 181 181 182 164 182 181 13 14 181 182 181 195 175 176 56 187 181 
181 186 29 30 31 30 31 30 33 150 151 179 180 102 120 101 101 100 150 151 169 196 197 197 197 197 197 197 197 197 197 197 197 197 197 197 197 197 197 13 14 197 197 197 198 177 178 126 187 181 
181 186 131 132 179 180 132 56 155 152 153 133 134 103 111 119 111 104 152 153 170 134 131 50 50 134 135 136 0 56 179 180 139 56 0 179 180 53 56 18 17 0 155 133 134 136 0 155 187 181 
181 188 189 189 189 189 189 189 189 189 189 189 189 189 189 189 189 189 189 189 189 189 189 189 189 189 189 189 189 189 189 189 189 189 189 189 189 189 189 189 189 189 189 189 189 189 189 189 190 181 
181 181 181 181 181 181 181 181 181 181 181 181 181 181 181 181 181 181 181 181 181 181 181 181 181 181 181 181 181 181 181 181 181 181 181 181 181 181 181 181 181 181 181 181 181 181 181 181 181 181 