28 28 28 28 28 28 28 28 28 28 28 28 28 28 28 28 28 28 28 28 28 28 28 28 28 28 28 28 28 28 28 28 28 28 28 28 28 28 28 28 28 28 28 28 28 28 28 28 28
28 28 28 28 28 28 28 28 28 28 28 28 28 28 28 28 28 28 28 28 28 28 28 28 28 28 28 28 28 28 28 28 28 28 28 28 28 28 28 28 28 28 28 28 28 28 28 28 28
28 28 28 28 28 28 28 28 28 28 28 28 28 28 28 28 28 28 28 28 28 28 28 28 28 28 28 28 28 28 28 28 28 28 28 28 28 28 28 28 28 28 28 28 28 28 28 28 28
28 28 28 28 28 28 28 28 28 28 28 28 28 28 28 28 28 28 28 28 28 28 28 28 28 28 28 28 28 28 28 28 28 28 28 28 28 28 28 28 28 28 28 28 28 28 28 28 28
28 28 28 28 28 28 28 28 28 28 28 28 28 28 28 28 28 28 28 28 28 28 28 28 28 28 28 28 28 28 28 28 28 28 28 28 28 28 28 28 28 28 28 28 28 28 28 28 28
28 28 28 28 28 28 28 28 28 28 28 28 28 28 28 28 28 28 28 28 28 28 28 28 28 28 28 28 28 28 28 28 28 28 28 28 28 28 28 28 28 28 28 28 28 28 28 28 28
28 28 28 28 28 28 28 28 28 28 28 28 28 28 28 28 28 28 28 28 28 28 28 28 28 28 28 28 28 28 28 28 28 28 28 28 28 28 28 28 28 28 28 28 28 28 28 28 28
28 28 28 28 28 28 28 28 28 28 28 28 28 28 28 28 28 28 28 28 28 28 28 28 28 28 28 28 28 28 28 28 28 28 28 28 28 28 28 28 28 28 28 28 28 28 28 28 28
28 28 28 28 28 28 28 28 28 28 28 28 28 28 28 28 28 28 28 28 28 28 28 28 28 28 28 28 28 28 28 28 28 28 28 28 28 28 28 28 28 28 28 28 28 28 28 28 28
28 0 90 12 0 14 15 15 78 79 87 88 80 81 7 8 9 87 88 12 13 35 35 35 35 88 7 8 87 15 15 14 183 30 180 12 13 14 15 16 87 88 178 7 8 9 10 11 128 80 0
28 0 88 17 0 0 20 21 80 81 89 77 78 79 12 13 14 15 16 17 18 19 20 21 89 77 12 13 14 15 16 19 185 30 181 17 18 19 20 21 89 77 175 12 13 14 15 16 7 10 0
28 0 77 128 50 0 79 7 8 9 10 11 87 88 17 18 19 20 21 44 86 90 113 7 8 9 87 88 19 20 21 83 183 30 182 177 173 177 173 174 86 90 178 17 18 19 20 21 12 15 0
28 0 9 10 0 80 81 12 13 14 15 16 89 77 173 173 173 177 7 8 87 88 11 12 13 14 15 16 50 7 10 11 183 30 181 7 8 9 11 175 87 88 175 44 0 50 44 50 17 20 0
28 0 14 15 0 86 90 17 18 19 20 21 172 173 179 7 8 9 12 13 14 15 16 17 18 19 20 21 0 12 15 16 183 30 180 12 13 14 16 175 89 77 178 177 173 177 173 177 173 177 0
28 0 19 20 0 87 88 83 48 49 50 128 175 87 13 87 15 16 17 18 19 20 21 128 78 79 86 90 0 17 20 21 185 30 180 17 18 19 20 176 177 173 175 44 7 8 9 10 11 78 0
28 0 79 0 51 89 77 54 7 8 9 10 175 17 18 19 20 21 113 7 8 9 10 11 80 81 87 88 78 79 78 79 183 30 182 120 7 8 9 10 11 50 178 0 12 13 14 15 16 87 0
28 0 88 0 8 9 10 11 12 13 14 15 176 175 86 90 78 79 48 12 13 14 15 16 50 48 89 77 87 88 87 88 184 25 181 0 12 13 14 15 16 128 175 0 17 18 19 20 21 89 0
28 0 77 12 13 14 15 16 17 18 19 20 122 178 87 88 80 81 128 17 18 19 20 21 7 8 10 9 89 77 80 81 185 25 181 50 17 18 19 20 21 122 178 78 79 7 8 9 10 11 0
28 0 128 17 18 19 20 21 128 0 0 0 119 178 89 77 50 172 177 173 177 173 177 173 12 13 14 15 45 0 78 79 183 29 182 7 8 9 10 11 50 46 178 80 81 12 13 14 15 16 0
28 0 8 9 10 11 0 119 173 177 173 177 173 175 50 0 128 175 7 8 9 10 9 11 17 18 19 20 7 8 87 88 185 29 181 12 13 14 15 16 78 79 175 78 79 17 18 19 20 21 0
28 0 13 14 15 16 7 8 9 10 11 78 79 178 173 173 173 179 12 13 14 15 15 16 8 9 10 11 12 13 15 88 184 29 182 17 18 19 20 21 80 81 178 87 88 86 90 7 8 9 0
28 0 18 19 20 21 12 13 14 15 16 87 88 175 0 78 79 50 17 18 19 20 19 20 12 13 15 16 17 18 19 20 185 24 181 78 79 50 128 83 50 128 175 89 77 87 88 12 13 14 0
28 0 50 44 128 0 17 18 19 20 21 89 77 178 128 80 81 83 117 118 128 45 45 121 17 18 20 21 119 120 0 49 183 30 180 87 88 7 8 9 10 11 178 0 128 89 77 17 18 19 0
28 0 39 95 39 39 95 39 94 39 94 95 39 94 39 95 39 39 95 95 94 95 39 95 39 39 39 95 39 39 39 95 189 30 180 89 77 12 13 14 15 16 176 177 173 174 53 50 78 79 0
28 0 29 25 29 28 26 29 28 28 29 29 29 24 29 29 29 29 29 29 28 29 24 29 29 29 28 29 29 24 24 29 25 29 180 83 0 17 18 19 20 21 0 50 55 178 83 47 80 81 0
28 0 188 186 186 188 186 187 186 186 188 186 186 187 186 188 186 186 186 186 187 186 188 186 186 187 186 186 186 188 186 186 192 25 181 170 35 35 35 35 35 35 35 35 171 175 169 35 35 35 0
28 0 48 141 142 128 48 50 111 125 44 50 48 112 50 124 50 117 118 50 0 124 44 119 128 114 0 111 120 44 124 44 183 28 180 31 110 0 64 65 66 133 134 117 83 178 124 0 22 110 0
28 0 151 151 151 151 151 151 151 151 151 151 151 151 151 151 151 151 151 151 151 151 151 151 151 151 151 151 151 151 152 111 185 29 182 31 44 76 67 68 69 135 136 0 83 175 0 131 0 46 0
28 0 143 143 143 143 143 126 143 143 143 143 143 143 143 143 116 143 143 143 143 143 143 115 116 143 143 143 143 143 163 113 183 28 180 31 137 138 70 71 72 0 137 138 83 178 0 132 131 131 0
28 0 143 127 159 160 160 160 160 160 160 160 160 160 160 160 160 160 160 160 160 160 160 160 160 160 161 143 143 143 163 44 183 29 181 31 139 140 73 74 75 0 139 140 83 175 137 138 132 132 0
28 0 143 116 163 44 44 122 0 50 0 48 0 7 8 9 9 11 78 79 48 7 8 9 10 11 162 143 116 143 163 124 184 29 180 31 82 22 129 178 108 83 83 83 83 178 139 140 76 129 0
28 0 126 143 163 78 79 7 8 9 10 11 22 12 13 14 15 16 87 88 0 12 13 14 15 88 162 115 143 143 163 118 183 29 182 31 110 48 130 176 173 177 173 177 173 179 54 50 110 130 0
28 0 143 143 163 80 81 12 13 14 15 16 0 17 18 19 20 21 89 77 0 87 13 14 15 16 162 143 143 143 163 119 185 29 180 31 84 85 82 84 85 82 84 85 82 84 85 82 84 85 0
28 0 143 143 163 50 0 17 18 19 20 21 50 0 50 52 0 0 48 0 22 17 18 19 20 21 162 143 143 143 163 120 184 28 181 169 35 35 35 35 35 35 35 35 35 35 35 35 35 35 0
28 0 143 115 156 157 157 157 157 157 157 157 157 157 157 157 157 157 157 157 157 157 157 157 157 157 158 143 143 143 163 122 183 24 180 78 79 86 90 7 8 9 10 11 45 7 8 9 10 11 0
28 0 143 143 143 126 143 143 143 116 143 143 143 123 1 143 143 143 127 143 143 143 126 143 2 143 143 143 143 143 163 131 183 29 182 80 81 87 88 12 13 14 15 16 45 12 13 14 15 16 0
28 0 143 143 143 143 143 143 143 143 143 143 143 143 2 143 143 143 143 143 159 160 160 160 160 160 160 160 161 143 163 132 183 29 181 83 0 89 77 17 18 19 20 21 128 17 18 19 20 21 0
28 0 143 159 160 160 160 160 160 160 160 161 143 143 2 143 143 115 143 143 163 40 39 39 39 39 39 38 162 143 163 121 183 23 190 95 39 39 39 39 39 39 39 39 39 39 39 39 39 38 0
28 0 143 163 7 8 9 10 11 50 83 162 143 143 2 143 143 143 143 143 163 183 23 23 23 23 23 181 162 143 163 129 184 24 29 29 28 29 29 23 23 28 24 23 23 23 23 28 23 181 0
28 0 143 163 12 13 14 15 16 53 172 162 4 5 2 5 5 5 5 6 163 183 23 23 23 23 23 182 162 143 163 130 183 23 191 187 186 186 187 186 188 186 187 186 186 186 186 192 23 180 0
28 0 143 163 17 18 19 20 21 22 175 162 143 143 2 143 143 143 143 143 163 41 186 186 186 186 186 43 162 143 163 122 183 23 180 78 79 83 82 78 79 0 83 50 82 86 90 185 23 182 0
28 0 115 163 0 177 173 177 173 177 179 162 143 143 2 143 143 143 143 143 156 157 157 157 157 157 157 157 158 143 163 128 41 42 43 80 81 0 50 80 81 82 0 50 48 87 88 183 28 180 0
28 0 143 163 53 83 0 0 118 0 50 162 143 143 2 143 143 143 143 143 143 143 143 116 2 143 143 143 143 143 156 157 157 157 157 157 157 157 157 157 157 157 157 151 152 89 77 183 30 182 0
28 0 143 156 157 157 157 157 157 157 157 158 143 143 2 143 143 143 143 143 143 143 143 143 2 143 143 143 143 143 143 143 143 1 143 115 143 143 143 143 143 143 143 143 154 78 79 185 30 180 0
28 0 143 143 143 143 143 143 143 143 143 143 143 143 2 116 143 143 143 143 143 143 143 143 2 143 143 143 143 143 143 143 143 2 143 143 143 143 143 143 143 143 143 143 154 87 88 183 28 180 0
28 0 143 143 143 143 143 143 126 143 143 143 143 143 2 143 143 143 143 143 143 143 143 143 2 143 143 143 143 143 143 143 143 2 143 143 143 143 143 143 143 143 143 143 154 89 77 185 30 181 0
28 0 116 143 143 143 143 143 143 143 143 143 143 115 2 143 143 143 143 143 143 116 143 143 2 143 143 143 143 143 143 143 143 2 143 143 143 143 143 143 143 116 143 143 154 78 79 183 25 182 0
28 0 143 143 143 143 143 143 143 143 143 143 143 143 2 143 143 143 143 143 143 143 143 143 2 143 143 143 143 143 143 143 143 2 143 126 143 143 143 143 143 143 143 127 154 80 81 185 30 180 0
28 0 5 5 5 5 5 5 5 5 5 5 5 5 5 5 5 5 5 5 5 5 5 5 5 5 5 5 5 5 5 5 5 2 5 5 5 5 5 5 5 5 5 6 154 86 90 183 25 180 0
28 0 143 143 116 143 143 143 143 143 143 143 155 143 2 143 143 143 143 143 143 143 143 143 3 143 143 143 116 143 143 143 143 2 143 143 143 143 143 143 143 116 143 143 154 87 88 183 24 181 0
28 0 143 143 143 143 143 143 143 143 143 143 143 143 2 143 115 143 143 143 143 116 159 160 160 161 143 143 143 143 143 143 143 2 143 115 143 143 143 143 143 143 143 143 154 89 77 184 30 182 0
28 0 143 155 143 143 143 143 143 143 143 143 143 143 2 143 143 143 143 143 143 143 163 0 0 162 143 143 143 143 115 143 143 2 143 143 143 143 143 155 143 143 143 143 154 50 128 184 30 180 0
28 0 143 143 143 143 143 143 143 116 143 143 143 143 2 143 143 143 115 143 143 143 156 157 157 158 143 143 143 143 143 143 143 2 143 143 143 143 143 143 143 143 143 127 154 78 79 184 30 181 0
28 0 143 127 143 143 143 143 143 143 143 143 143 126 3 143 143 143 143 143 143 143 143 143 143 143 143 143 143 143 143 143 126 3 143 143 116 143 143 143 143 143 143 143 154 87 88 183 25 180 0
28 0 165 165 165 165 165 165 165 165 165 165 165 165 165 165 165 165 165 165 165 165 165 165 165 165 165 165 165 165 165 165 165 165 165 165 165 165 165 165 165 165 165 165 166 89 77 184 30 180 0
28 0 7 8 9 10 11 46 0 0 49 47 46 120 119 0 7 8 9 10 11 0 86 90 50 7 8 9 10 11 78 79 185 23 190 95 39 39 94 39 39 39 94 39 39 95 94 189 30 181 0
28 0 12 13 14 15 16 46 49 46 78 79 49 54 45 50 12 13 14 15 16 48 87 88 22 12 13 14 15 16 80 81 184 23 23 23 23 23 23 23 23 23 24 30 28 25 30 24 24 182 0
28 0 0 0 0 0 0 0 0 0 0 0 0 0 0 0 0 0 0 0 0 0 0 0 0 0 0 0 0 0 0 0 0 0 0 0 0 0 0 0 0 0 0 0 0 0 0 0 0 0 0
